"date","tcc.continent","n.contributors","troops","police","observers","total"
1990-11-30,"Africa",7,924,0,0,924
1990-11-30,"Asia",8,929,0,0,929
1990-11-30,"Europe",19,6502,18,0,6520
1990-11-30,"North America",2,1035,0,0,1035
1990-11-30,"Oceania",3,756,26,0,782
1990-11-30,"South America",7,139,0,0,139
1990-12-31,"Africa",7,924,0,0,924
1990-12-31,"Asia",8,929,0,0,929
1990-12-31,"Europe",19,6502,18,0,6520
1990-12-31,"North America",2,1035,0,0,1035
1990-12-31,"Oceania",3,756,26,0,782
1990-12-31,"South America",7,139,0,0,139
1991-01-31,"Africa",7,924,0,0,924
1991-01-31,"Asia",8,929,0,0,929
1991-01-31,"Europe",19,6502,18,0,6520
1991-01-31,"North America",2,1035,0,0,1035
1991-01-31,"Oceania",3,756,26,0,782
1991-01-31,"South America",7,139,0,0,139
1991-02-28,"Africa",7,924,0,0,924
1991-02-28,"Asia",8,929,0,0,929
1991-02-28,"Europe",19,6502,18,0,6520
1991-02-28,"North America",2,1035,0,0,1035
1991-02-28,"Oceania",3,756,26,0,782
1991-02-28,"South America",7,139,0,0,139
1991-03-31,"Africa",3,907,0,0,907
1991-03-31,"Asia",4,878,0,0,878
1991-03-31,"Europe",18,6228,18,0,6246
1991-03-31,"North America",2,884,0,0,884
1991-03-31,"Oceania",3,743,19,0,762
1991-03-31,"South America",7,104,0,0,104
1991-04-30,"Africa",5,930,0,0,930
1991-04-30,"Asia",10,949,0,0,949
1991-04-30,"Europe",20,6682,18,0,6700
1991-04-30,"North America",2,1196,0,0,1196
1991-04-30,"Oceania",2,741,20,0,761
1991-04-30,"South America",7,177,0,0,177
1991-05-31,"Africa",6,936,0,0,936
1991-05-31,"Asia",10,952,0,0,952
1991-05-31,"Europe",21,6665,18,0,6683
1991-05-31,"North America",2,1197,0,0,1197
1991-05-31,"Oceania",3,743,20,0,763
1991-05-31,"South America",7,169,0,0,169
1991-06-30,"Africa",6,936,0,0,936
1991-06-30,"Asia",11,958,0,0,958
1991-06-30,"Europe",21,6650,18,0,6668
1991-06-30,"North America",2,1200,0,0,1200
1991-06-30,"Oceania",3,745,20,0,765
1991-06-30,"South America",7,168,0,0,168
1991-07-31,"Africa",10,989,0,0,989
1991-07-31,"Asia",11,985,0,0,985
1991-07-31,"Europe",21,6712,17,0,6729
1991-07-31,"North America",2,1206,0,0,1206
1991-07-31,"Oceania",3,749,20,0,769
1991-07-31,"South America",7,183,0,0,183
1991-08-31,"Africa",10,983,0,0,983
1991-08-31,"Asia",11,985,0,0,985
1991-08-31,"Europe",21,6696,17,0,6713
1991-08-31,"North America",2,1202,0,0,1202
1991-08-31,"Oceania",3,749,20,0,769
1991-08-31,"South America",7,183,0,0,183
1991-09-30,"Africa",12,1039,10,0,1049
1991-09-30,"Asia",11,1017,5,0,1022
1991-09-30,"Europe",21,6813,75,0,6888
1991-09-30,"North America",2,1259,0,0,1259
1991-09-30,"Oceania",3,798,19,0,817
1991-09-30,"South America",8,212,20,0,232
1991-10-31,"Africa",12,1057,0,0,1057
1991-10-31,"Asia",11,1020,0,0,1020
1991-10-31,"Europe",21,6786,0,0,6786
1991-10-31,"North America",2,1063,0,0,1063
1991-10-31,"Oceania",3,808,0,0,808
1991-10-31,"South America",8,247,0,0,247
1991-11-30,"Africa",12,1077,29,0,1106
1991-11-30,"Asia",11,1031,11,0,1042
1991-11-30,"Europe",21,6909,75,0,6984
1991-11-30,"North America",2,1064,0,0,1064
1991-11-30,"Oceania",3,870,20,0,890
1991-11-30,"South America",8,258,20,0,278
1991-12-31,"Africa",11,1061,29,0,1090
1991-12-31,"Asia",11,1025,11,0,1036
1991-12-31,"Europe",21,6905,75,0,6980
1991-12-31,"North America",2,1043,0,0,1043
1991-12-31,"Oceania",3,870,20,0,890
1991-12-31,"South America",8,232,20,0,252
1992-01-31,"Africa",9,1024,19,0,1043
1992-01-31,"Asia",11,1038,11,0,1049
1992-01-31,"Europe",19,7077,75,0,7152
1992-01-31,"North America",2,1111,0,0,1111
1992-01-31,"Oceania",3,866,20,0,886
1992-01-31,"South America",7,348,20,0,368
1992-02-29,"Africa",9,1058,27,0,1085
1992-02-29,"Asia",11,1794,9,0,1803
1992-02-29,"Europe",20,7105,190,0,7295
1992-02-29,"North America",2,894,0,0,894
1992-02-29,"Oceania",3,894,19,0,913
1992-02-29,"South America",8,287,141,0,428
1992-03-31,"Africa",9,1070,35,0,1105
1992-03-31,"Asia",12,3533,41,0,3574
1992-03-31,"Europe",20,7135,269,0,7404
1992-03-31,"North America",2,1131,0,0,1131
1992-03-31,"Oceania",3,1019,19,0,1038
1992-03-31,"South America",9,295,130,0,425
1992-04-30,"Africa",10,1171,77,0,1248
1992-04-30,"Asia",12,5001,181,0,5182
1992-04-30,"Europe",23,13309,641,0,13950
1992-04-30,"North America",2,2210,0,0,2210
1992-04-30,"Oceania",3,1026,20,0,1046
1992-04-30,"South America",10,1149,213,0,1362
1992-05-31,"Africa",10,1171,77,0,1248
1992-05-31,"Asia",12,5001,181,0,5182
1992-05-31,"Europe",23,13309,641,0,13950
1992-05-31,"North America",2,2210,0,0,2210
1992-05-31,"Oceania",3,1026,20,0,1046
1992-05-31,"South America",10,1149,213,0,1362
1992-06-30,"Africa",10,1171,77,0,1248
1992-06-30,"Asia",12,5001,181,0,5182
1992-06-30,"Europe",23,13309,641,0,13950
1992-06-30,"North America",2,2210,0,0,2210
1992-06-30,"Oceania",3,1026,20,0,1046
1992-06-30,"South America",10,1149,213,0,1362
1992-07-31,"Africa",10,1171,77,0,1248
1992-07-31,"Asia",12,5001,181,0,5182
1992-07-31,"Europe",23,13309,641,0,13950
1992-07-31,"North America",2,2210,0,0,2210
1992-07-31,"Oceania",3,1026,20,0,1046
1992-07-31,"South America",10,1149,213,0,1362
1992-08-31,"Africa",10,5650,936,266,6852
1992-08-31,"Asia",12,9412,1595,356,11363
1992-08-31,"Europe",23,17218,911,1034,19163
1992-08-31,"North America",2,2215,30,181,2426
1992-08-31,"Oceania",3,1378,79,50,1507
1992-08-31,"South America",10,1941,335,251,2527
1992-09-30,"Africa",12,4730,985,304,6019
1992-09-30,"Asia",13,10116,1329,364,11809
1992-09-30,"Europe",24,17944,932,1012,19888
1992-09-30,"North America",2,2184,30,185,2399
1992-09-30,"Oceania",3,1321,80,51,1452
1992-09-30,"South America",11,1940,413,213,2566
1992-10-31,"Africa",12,5520,1137,310,6967
1992-10-31,"Asia",13,9762,1657,334,11753
1992-10-31,"Europe",24,17134,938,978,19050
1992-10-31,"North America",2,2174,45,183,2402
1992-10-31,"Oceania",3,1407,80,48,1535
1992-10-31,"South America",10,1934,395,192,2521
1992-11-30,"Africa",12,5480,1131,304,6915
1992-11-30,"Asia",13,9777,1657,338,11772
1992-11-30,"Europe",23,22780,878,989,24647
1992-11-30,"North America",2,3461,45,170,3676
1992-11-30,"Oceania",3,1369,80,47,1496
1992-11-30,"South America",10,1897,395,193,2485
1992-12-31,"Africa",12,5469,1143,300,6912
1992-12-31,"Asia",13,10824,1847,343,13014
1992-12-31,"Europe",23,22780,893,1008,24681
1992-12-31,"North America",2,3516,45,160,3721
1992-12-31,"Oceania",3,1286,80,45,1411
1992-12-31,"South America",10,1900,405,210,2515
1993-01-31,"Africa",13,4864,972,221,6057
1993-01-31,"Asia",14,10092,2708,356,13156
1993-01-31,"Europe",25,22830,1023,1366,25219
1993-01-31,"North America",2,3561,45,178,3784
1993-01-31,"Oceania",3,1349,80,43,1472
1993-01-31,"South America",10,1911,387,209,2507
1993-02-28,"Africa",16,4846,966,218,6030
1993-02-28,"Asia",14,10447,2714,365,13526
1993-02-28,"Europe",24,23774,1009,1318,26101
1993-02-28,"North America",2,3510,47,177,3734
1993-02-28,"Oceania",3,1347,83,43,1473
1993-02-28,"South America",10,1905,382,192,2479
1993-03-31,"Africa",16,4856,994,203,6053
1993-03-31,"Asia",14,10516,2708,374,13598
1993-03-31,"Europe",24,24583,1022,1283,26888
1993-03-31,"North America",2,3496,45,172,3713
1993-03-31,"Oceania",3,1190,82,37,1309
1993-03-31,"South America",10,1915,382,186,2483
1993-04-30,"Africa",16,5576,1413,222,7211
1993-04-30,"Asia",14,10647,2697,366,13710
1993-04-30,"Europe",25,25527,1005,1308,27840
1993-04-30,"North America",2,3580,47,177,3804
1993-04-30,"Oceania",3,1379,80,32,1491
1993-04-30,"South America",10,2764,382,194,3340
1993-05-31,"Africa",16,8988,969,223,10180
1993-05-31,"Asia",15,17603,2685,382,20670
1993-05-31,"Europe",25,30257,1012,1261,32530
1993-05-31,"North America",2,6158,47,159,6364
1993-05-31,"Oceania",3,1441,81,36,1558
1993-05-31,"South America",10,2769,393,190,3352
1993-06-30,"Africa",16,9379,982,225,10586
1993-06-30,"Asia",17,19220,2418,382,22020
1993-06-30,"Europe",25,32133,871,1299,34303
1993-06-30,"North America",2,5894,47,163,6104
1993-06-30,"Oceania",3,1311,81,37,1429
1993-06-30,"South America",10,2784,400,170,3354
1993-07-31,"Africa",16,8935,924,221,10080
1993-07-31,"Asia",16,18085,2675,401,21161
1993-07-31,"Europe",25,32579,1226,1326,35131
1993-07-31,"North America",2,6049,46,165,6260
1993-07-31,"Oceania",3,1552,81,37,1670
1993-07-31,"South America",10,2782,403,170,3355
1993-08-31,"Africa",16,8472,234,237,8943
1993-08-31,"Asia",16,18974,1489,356,20819
1993-08-31,"Europe",24,33286,925,1315,35526
1993-08-31,"North America",2,5947,46,170,6163
1993-08-31,"Oceania",3,1312,33,37,1382
1993-08-31,"South America",10,1943,246,188,2377
1993-09-30,"Africa",16,8504,129,272,8905
1993-09-30,"Asia",17,20875,868,430,22173
1993-09-30,"Europe",24,33233,683,1329,35245
1993-09-30,"North America",2,5798,46,158,6002
1993-09-30,"Oceania",3,1308,26,37,1371
1993-09-30,"South America",10,2013,253,196,2462
1993-10-31,"Africa",15,7762,140,267,8169
1993-10-31,"Asia",17,21846,163,417,22426
1993-10-31,"Europe",24,32344,463,1252,34059
1993-10-31,"North America",2,6526,45,132,6703
1993-10-31,"Oceania",3,971,24,37,1032
1993-10-31,"South America",10,2268,204,192,2664
1993-11-30,"Africa",14,8866,132,327,9325
1993-11-30,"Asia",16,20208,160,436,20804
1993-11-30,"Europe",23,30299,481,1235,32015
1993-11-30,"North America",2,6304,44,125,6473
1993-11-30,"Oceania",3,786,21,41,848
1993-11-30,"South America",10,2259,208,185,2652
1993-12-31,"Africa",15,9003,133,363,9499
1993-12-31,"Asia",16,21789,163,529,22481
1993-12-31,"Europe",23,28356,476,873,29705
1993-12-31,"North America",2,4538,46,126,4710
1993-12-31,"Oceania",3,787,20,42,849
1993-12-31,"South America",10,2235,210,242,2687
1994-01-31,"Africa",16,8969,123,440,9532
1994-01-31,"Asia",16,22013,223,568,22804
1994-01-31,"Europe",23,28728,504,914,30146
1994-01-31,"North America",2,4209,46,123,4378
1994-01-31,"Oceania",3,777,20,42,839
1994-01-31,"South America",10,2233,235,223,2691
1994-02-28,"Africa",16,9311,142,473,9926
1994-02-28,"Asia",16,24092,225,598,24915
1994-02-28,"Europe",23,28974,535,879,30388
1994-02-28,"North America",2,2828,46,128,3002
1994-02-28,"Oceania",3,782,20,42,844
1994-02-28,"South America",10,2298,247,218,2763
1994-03-31,"Africa",17,9663,178,479,10320
1994-03-31,"Asia",12,23055,228,610,23893
1994-03-31,"Europe",23,27556,568,904,29028
1994-03-31,"North America",2,2851,46,129,3026
1994-03-31,"Oceania",3,775,36,42,853
1994-03-31,"South America",9,2236,241,249,2726
1994-04-30,"Africa",17,9282,183,476,9941
1994-04-30,"Asia",12,23420,261,589,24270
1994-04-30,"Europe",23,28555,543,913,30011
1994-04-30,"North America",2,2999,45,128,3172
1994-04-30,"Oceania",3,805,36,41,882
1994-04-30,"South America",9,2176,239,231,2646
1994-05-31,"Africa",17,8093,276,460,8829
1994-05-31,"Asia",14,24008,309,557,24874
1994-05-31,"Europe",23,28482,590,897,29969
1994-05-31,"North America",2,3132,45,128,3305
1994-05-31,"Oceania",3,804,36,44,884
1994-05-31,"South America",9,2172,245,254,2671
1994-06-30,"Africa",17,8063,258,492,8813
1994-06-30,"Asia",14,25725,568,628,26921
1994-06-30,"Europe",23,27594,607,929,29130
1994-06-30,"North America",2,3140,46,118,3304
1994-06-30,"Oceania",3,712,37,41,790
1994-06-30,"South America",9,2184,239,255,2678
1994-07-31,"Africa",17,8167,346,438,8951
1994-07-31,"Asia",14,25169,623,634,26426
1994-07-31,"Europe",23,29117,653,915,30685
1994-07-31,"North America",2,3437,46,108,3591
1994-07-31,"Oceania",3,724,37,41,802
1994-07-31,"South America",9,2353,226,242,2821
1994-08-31,"Africa",19,9643,355,484,10482
1994-08-31,"Asia",14,26010,539,641,27190
1994-08-31,"Europe",23,28973,652,922,30547
1994-08-31,"North America",2,3514,46,120,3680
1994-08-31,"Oceania",3,1845,37,42,1924
1994-08-31,"South America",9,2354,230,252,2836
1994-09-30,"Africa",21,10029,486,626,11141
1994-09-30,"Asia",14,26954,626,623,28203
1994-09-30,"Europe",23,29372,645,916,30933
1994-09-30,"North America",2,3486,45,119,3650
1994-09-30,"Oceania",3,1853,303,46,2202
1994-09-30,"South America",9,2361,218,238,2817
1994-10-31,"Africa",20,9000,504,577,10081
1994-10-31,"Asia",15,25711,696,521,26928
1994-10-31,"Europe",24,28435,645,900,29980
1994-10-31,"North America",2,3470,62,118,3650
1994-10-31,"Oceania",3,1835,286,44,2165
1994-10-31,"South America",9,3111,235,224,3570
1994-11-30,"Africa",20,9098,535,569,10202
1994-11-30,"Asia",15,26110,668,519,27297
1994-11-30,"Europe",25,27593,504,900,28997
1994-11-30,"North America",2,3441,63,122,3626
1994-11-30,"Oceania",3,1772,285,43,2100
1994-11-30,"South America",10,2927,142,208,3277
1994-12-31,"Africa",20,8298,560,586,9444
1994-12-31,"Asia",15,21398,664,544,22606
1994-12-31,"Europe",25,27582,529,905,29016
1994-12-31,"North America",2,3585,65,124,3774
1994-12-31,"Oceania",3,2022,35,43,2100
1994-12-31,"South America",10,2932,140,213,3285
1995-01-31,"Africa",19,7776,314,581,8671
1995-01-31,"Asia",13,19384,263,489,20136
1995-01-31,"Europe",25,27056,421,876,28353
1995-01-31,"North America",2,3346,68,118,3532
1995-01-31,"Oceania",3,2015,19,43,2077
1995-01-31,"South America",11,1311,66,172,1549
1995-02-28,"Africa",20,7348,342,606,8296
1995-02-28,"Asia",12,12757,261,534,13552
1995-02-28,"Europe",25,27130,452,929,28511
1995-02-28,"North America",2,3512,136,120,3768
1995-02-28,"Oceania",3,2015,19,43,2077
1995-02-28,"South America",11,1315,81,184,1580
1995-03-31,"Africa",19,6512,386,496,7394
1995-03-31,"Asia",12,14978,611,531,16120
1995-03-31,"Europe",26,26356,477,890,27723
1995-03-31,"North America",2,6152,145,118,6415
1995-03-31,"Oceania",3,2013,29,56,2098
1995-03-31,"South America",14,1639,191,181,2011
1995-04-30,"Africa",19,5670,360,505,6535
1995-04-30,"Asia",12,16636,620,536,17792
1995-04-30,"Europe",26,25404,512,897,26813
1995-04-30,"North America",2,6079,145,117,6341
1995-04-30,"Oceania",3,2181,30,41,2252
1995-04-30,"South America",16,1661,220,181,2062
1995-05-31,"Africa",20,6508,431,516,7455
1995-05-31,"Asia",13,16874,667,528,18069
1995-05-31,"Europe",27,26579,474,911,27964
1995-05-31,"North America",2,6173,103,115,6391
1995-05-31,"Oceania",3,2019,28,42,2089
1995-05-31,"South America",16,2713,217,177,3107
1995-06-30,"Africa",20,6506,393,507,7406
1995-06-30,"Asia",13,16242,659,523,17424
1995-06-30,"Europe",27,28840,446,912,30198
1995-06-30,"North America",2,6117,103,115,6335
1995-06-30,"Oceania",3,2049,30,43,2122
1995-06-30,"South America",16,2723,214,175,3112
1995-07-31,"Africa",20,4713,363,504,5580
1995-07-31,"Asia",13,15686,645,522,16853
1995-07-31,"Europe",27,33237,415,926,34578
1995-07-31,"North America",2,5993,99,117,6209
1995-07-31,"Oceania",3,1229,30,42,1301
1995-07-31,"South America",16,2379,214,177,2770
1995-08-31,"Africa",21,4422,376,497,5295
1995-08-31,"Asia",13,16411,595,507,17513
1995-08-31,"Europe",27,34736,423,914,36073
1995-08-31,"North America",2,6061,87,105,6253
1995-08-31,"Oceania",3,913,30,42,985
1995-08-31,"South America",16,2383,213,175,2771
1995-09-30,"Africa",21,3253,400,487,4140
1995-09-30,"Asia",13,14362,591,516,15469
1995-09-30,"Europe",27,32446,473,906,33825
1995-09-30,"North America",2,5312,97,101,5510
1995-09-30,"Oceania",3,907,30,43,980
1995-09-30,"South America",15,2265,144,165,2574
1995-10-31,"Africa",21,3019,388,482,3889
1995-10-31,"Asia",13,14618,533,523,15674
1995-10-31,"Europe",27,29626,477,867,30970
1995-10-31,"North America",2,5192,96,101,5389
1995-10-31,"Oceania",3,875,30,42,947
1995-10-31,"South America",15,2876,145,179,3200
1995-11-30,"Africa",21,3009,379,455,3843
1995-11-30,"Asia",12,10628,176,489,11293
1995-11-30,"Europe",25,28008,448,847,29303
1995-11-30,"North America",2,4464,95,101,4660
1995-11-30,"Oceania",3,876,30,42,948
1995-11-30,"South America",15,2848,140,173,3161
1995-12-31,"Africa",19,2861,286,424,3571
1995-12-31,"Asia",12,7367,172,465,8004
1995-12-31,"Europe",25,10490,411,818,11719
1995-12-31,"North America",2,3821,93,100,4014
1995-12-31,"Oceania",3,682,30,40,752
1995-12-31,"South America",14,2775,106,160,3041
1996-01-31,"Africa",19,2784,272,373,3429
1996-01-31,"Asia",12,8018,241,400,8659
1996-01-31,"Europe",25,9219,475,689,10383
1996-01-31,"North America",2,3220,93,92,3405
1996-01-31,"Oceania",3,641,30,37,708
1996-01-31,"South America",9,2367,40,159,2566
1996-02-29,"Africa",19,2614,293,354,3261
1996-02-29,"Asia",13,6201,300,383,6884
1996-02-29,"Europe",25,8833,596,651,10080
1996-02-29,"North America",2,2953,93,77,3123
1996-02-29,"Oceania",3,600,30,36,666
1996-02-29,"South America",8,2187,33,145,2365
1996-03-31,"Africa",18,2461,347,272,3080
1996-03-31,"Asia",13,5723,651,362,6736
1996-03-31,"Europe",25,9223,702,623,10548
1996-03-31,"North America",2,1645,108,75,1828
1996-03-31,"Oceania",3,596,80,34,710
1996-03-31,"South America",9,2370,61,125,2556
1996-04-30,"Africa",16,2226,385,237,2848
1996-04-30,"Asia",13,5840,661,330,6831
1996-04-30,"Europe",25,9518,822,618,10958
1996-04-30,"North America",2,1509,198,75,1782
1996-04-30,"Oceania",3,592,77,35,704
1996-04-30,"South America",9,2363,55,117,2535
1996-05-31,"Africa",16,2227,436,230,2893
1996-05-31,"Asia",13,6523,697,323,7543
1996-05-31,"Europe",25,9484,962,612,11058
1996-05-31,"North America",2,1495,291,73,1859
1996-05-31,"Oceania",3,589,77,35,701
1996-05-31,"South America",9,2454,129,116,2699
1996-06-30,"Africa",16,2220,449,241,2910
1996-06-30,"Asia",13,6365,803,311,7479
1996-06-30,"Europe",26,9225,918,623,10766
1996-06-30,"North America",2,1493,285,69,1847
1996-06-30,"Oceania",3,603,68,35,706
1996-06-30,"South America",9,2467,110,114,2691
1996-07-31,"Africa",16,2144,455,240,2839
1996-07-31,"Asia",13,5375,810,305,6490
1996-07-31,"Europe",27,8908,968,638,10514
1996-07-31,"North America",2,1460,304,56,1820
1996-07-31,"Oceania",3,600,66,36,702
1996-07-31,"South America",9,2382,99,201,2682
1996-08-31,"Africa",16,2229,455,230,2914
1996-08-31,"Asia",13,5597,809,297,6703
1996-08-31,"Europe",27,9300,986,599,10885
1996-08-31,"North America",2,1350,302,53,1705
1996-08-31,"Oceania",3,598,64,34,696
1996-08-31,"South America",9,2478,147,108,2733
1996-09-30,"Africa",16,2233,454,225,2912
1996-09-30,"Asia",13,5590,789,296,6675
1996-09-30,"Europe",27,9176,1006,596,10778
1996-09-30,"North America",2,1384,297,53,1734
1996-09-30,"Oceania",3,627,64,35,726
1996-09-30,"South America",9,2479,96,110,2685
1996-10-31,"Africa",16,2234,453,228,2915
1996-10-31,"Asia",13,5594,787,295,6676
1996-10-31,"Europe",27,9382,1033,592,11007
1996-10-31,"North America",2,1430,332,53,1815
1996-10-31,"Oceania",3,609,66,34,709
1996-10-31,"South America",9,2447,96,105,2648
1996-11-30,"Africa",16,2243,454,232,2929
1996-11-30,"Asia",13,5573,792,305,6670
1996-11-30,"Europe",27,9256,1036,597,10889
1996-11-30,"North America",2,1433,333,53,1819
1996-11-30,"Oceania",3,610,66,35,711
1996-11-30,"South America",9,2450,94,112,2656
1996-12-31,"Africa",15,2238,441,245,2924
1996-12-31,"Asia",13,5382,788,333,6503
1996-12-31,"Europe",27,8875,1036,583,10494
1996-12-31,"North America",2,1421,330,52,1803
1996-12-31,"Oceania",3,602,66,35,703
1996-12-31,"South America",8,2295,87,111,2493
1997-01-31,"Africa",15,2237,441,256,2934
1997-01-31,"Asia",13,5369,769,325,6463
1997-01-31,"Europe",27,8871,1034,598,10503
1997-01-31,"North America",2,1438,358,51,1847
1997-01-31,"Oceania",3,597,66,37,700
1997-01-31,"South America",9,2315,91,117,2523
1997-02-28,"Africa",15,1723,406,240,2369
1997-02-28,"Asia",13,5360,681,334,6375
1997-02-28,"Europe",27,8831,1003,654,10488
1997-02-28,"North America",2,1394,353,71,1818
1997-02-28,"Oceania",3,594,66,36,696
1997-02-28,"South America",10,2180,110,162,2452
1997-03-31,"Africa",15,2106,412,261,2779
1997-03-31,"Asia",13,5216,685,376,6277
1997-03-31,"Europe",27,8819,1001,639,10459
1997-03-31,"North America",2,1432,358,71,1861
1997-03-31,"Oceania",3,590,66,37,693
1997-03-31,"South America",10,1513,114,161,1788
1997-04-30,"Africa",15,2097,424,237,2758
1997-04-30,"Asia",13,5003,766,323,6092
1997-04-30,"Europe",27,9014,1070,633,10717
1997-04-30,"North America",2,1457,342,71,1870
1997-04-30,"Oceania",3,590,65,36,691
1997-04-30,"South America",10,1497,111,159,1767
1997-05-31,"Africa",15,2077,435,232,2744
1997-05-31,"Asia",13,4730,690,300,5720
1997-05-31,"Europe",27,8792,1128,563,10483
1997-05-31,"North America",2,1466,359,51,1876
1997-05-31,"Oceania",3,590,65,34,689
1997-05-31,"South America",8,1288,108,106,1502
1997-06-30,"Africa",16,2067,418,220,2705
1997-06-30,"Asia",13,4642,727,308,5677
1997-06-30,"Europe",27,8197,1208,570,9975
1997-06-30,"North America",2,1451,404,52,1907
1997-06-30,"Oceania",3,626,63,34,723
1997-06-30,"South America",8,1244,109,103,1456
1997-07-31,"Africa",16,2061,426,215,2702
1997-07-31,"Asia",13,3332,742,311,4385
1997-07-31,"Europe",27,7936,1214,533,9683
1997-07-31,"North America",2,1435,386,54,1875
1997-07-31,"Oceania",3,616,63,33,712
1997-07-31,"South America",8,953,126,102,1181
1997-08-31,"Africa",15,2060,431,196,2687
1997-08-31,"Asia",13,2653,788,271,3712
1997-08-31,"Europe",27,7791,1233,527,9551
1997-08-31,"North America",2,1373,383,49,1805
1997-08-31,"Oceania",3,616,62,34,712
1997-08-31,"South America",8,503,142,100,745
1997-09-30,"Africa",15,2009,423,182,2614
1997-09-30,"Asia",13,2577,768,259,3604
1997-09-30,"Europe",27,7776,1211,527,9514
1997-09-30,"North America",2,1267,372,49,1688
1997-09-30,"Oceania",3,608,62,34,704
1997-09-30,"South America",8,454,140,100,694
1997-10-31,"Africa",16,2009,462,175,2646
1997-10-31,"Asia",13,2577,765,266,3608
1997-10-31,"Europe",28,7247,1234,509,8990
1997-10-31,"North America",2,1298,348,49,1695
1997-10-31,"Oceania",3,599,62,33,694
1997-10-31,"South America",8,451,145,97,693
1997-11-30,"Africa",16,2004,428,178,2610
1997-11-30,"Asia",13,2301,816,261,3378
1997-11-30,"Europe",29,6179,1251,512,7942
1997-11-30,"North America",2,1158,319,49,1526
1997-11-30,"Oceania",3,597,62,34,693
1997-11-30,"South America",7,454,146,93,693
1997-12-31,"Africa",16,1392,474,173,2039
1997-12-31,"Asia",13,1746,806,235,2787
1997-12-31,"Europe",29,5959,1205,504,7668
1997-12-31,"North America",2,537,312,49,898
1997-12-31,"Oceania",3,585,62,33,680
1997-12-31,"South America",7,453,278,85,816
1998-01-31,"Africa",16,1093,402,129,1624
1998-01-31,"Asia",13,1644,816,208,2668
1998-01-31,"Europe",29,5053,1134,450,6637
1998-01-31,"North America",2,534,208,49,791
1998-01-31,"Oceania",3,582,62,30,674
1998-01-31,"South America",7,453,279,75,807
1998-02-28,"Africa",16,948,411,117,1476
1998-02-28,"Asia",13,1659,766,200,2625
1998-02-28,"Europe",29,5244,1221,456,6921
1998-02-28,"North America",2,590,308,48,946
1998-02-28,"Oceania",3,580,35,29,644
1998-02-28,"South America",7,453,270,80,803
1998-03-31,"Africa",16,969,396,114,1479
1998-03-31,"Asia",13,1657,717,187,2561
1998-03-31,"Europe",29,5234,1186,453,6873
1998-03-31,"North America",2,538,316,49,903
1998-03-31,"Oceania",3,579,28,29,636
1998-03-31,"South America",7,455,264,77,796
1998-04-30,"Africa",20,1962,380,117,2459
1998-04-30,"Asia",13,1661,714,190,2565
1998-04-30,"Europe",29,5410,1210,452,7072
1998-04-30,"North America",2,696,265,47,1008
1998-04-30,"Oceania",3,574,35,29,638
1998-04-30,"South America",7,455,271,77,803
1998-05-31,"Africa",20,1947,389,114,2450
1998-05-31,"Asia",13,1681,711,186,2578
1998-05-31,"Europe",29,5382,1224,455,7061
1998-05-31,"North America",2,705,295,47,1047
1998-05-31,"Oceania",3,570,35,29,634
1998-05-31,"South America",7,463,265,78,806
1998-06-30,"Africa",21,1948,408,118,2474
1998-06-30,"Asia",13,1728,692,194,2614
1998-06-30,"Europe",29,5374,1241,454,7069
1998-06-30,"North America",2,693,315,47,1055
1998-06-30,"Oceania",3,586,34,32,652
1998-06-30,"South America",7,467,285,78,830
1998-07-31,"Africa",21,1929,427,114,2470
1998-07-31,"Asia",13,1776,657,197,2630
1998-07-31,"Europe",29,5368,1281,455,7104
1998-07-31,"North America",2,681,313,47,1041
1998-07-31,"Oceania",3,582,35,31,648
1998-07-31,"South America",7,467,280,76,823
1998-08-31,"Africa",21,1921,420,115,2456
1998-08-31,"Asia",14,1841,662,189,2692
1998-08-31,"Europe",29,5359,1267,463,7089
1998-08-31,"North America",2,683,306,47,1036
1998-08-31,"Oceania",3,572,35,31,638
1998-08-31,"South America",7,468,266,75,809
1998-09-30,"Africa",22,1921,397,118,2436
1998-09-30,"Asia",14,1846,644,193,2683
1998-09-30,"Europe",28,5363,1260,458,7081
1998-09-30,"North America",2,689,310,48,1047
1998-09-30,"Oceania",3,571,33,32,636
1998-09-30,"South America",7,466,261,73,800
1998-10-31,"Africa",22,1918,394,118,2430
1998-10-31,"Asia",14,1831,635,197,2663
1998-10-31,"Europe",29,5095,1186,450,6731
1998-10-31,"North America",2,689,272,48,1009
1998-10-31,"Oceania",3,592,33,25,650
1998-10-31,"South America",7,465,268,73,806
1998-11-30,"Africa",22,1914,365,119,2398
1998-11-30,"Asia",14,2462,626,199,3287
1998-11-30,"Europe",29,4708,1177,449,6334
1998-11-30,"North America",2,695,254,48,997
1998-11-30,"Oceania",3,587,40,31,658
1998-11-30,"South America",7,463,265,74,802
1998-12-31,"Africa",22,1914,365,119,2398
1998-12-31,"Asia",14,2462,626,199,3287
1998-12-31,"Europe",29,4708,1177,449,6334
1998-12-31,"North America",2,695,254,48,997
1998-12-31,"Oceania",3,587,40,31,658
1998-12-31,"South America",7,463,265,74,802
1999-01-31,"Africa",22,1911,311,97,2319
1999-01-31,"Asia",13,2304,578,185,3067
1999-01-31,"Europe",29,4720,1071,422,6213
1999-01-31,"North America",2,705,283,47,1035
1999-01-31,"Oceania",3,587,40,29,656
1999-01-31,"South America",7,477,196,67,740
1999-02-28,"Africa",22,1884,282,86,2252
1999-02-28,"Asia",14,2277,612,177,3066
1999-02-28,"Europe",30,4550,1086,387,6023
1999-02-28,"North America",2,602,287,47,936
1999-02-28,"Oceania",3,586,40,25,651
1999-02-28,"South America",7,500,218,65,783
1999-03-31,"Africa",19,1966,251,77,2294
1999-03-31,"Asia",14,2195,528,168,2891
1999-03-31,"Europe",29,3770,1053,373,5196
1999-03-31,"North America",2,242,275,46,563
1999-03-31,"Oceania",3,585,40,26,651
1999-03-31,"South America",7,530,210,62,802
1999-04-30,"Africa",18,1877,257,72,2206
1999-04-30,"Asia",14,2085,528,173,2786
1999-04-30,"Europe",29,3898,984,397,5279
1999-04-30,"North America",2,215,247,46,508
1999-04-30,"Oceania",3,579,24,28,631
1999-04-30,"South America",7,513,173,62,748
1999-05-31,"Africa",18,1851,260,80,2191
1999-05-31,"Asia",14,2108,581,171,2860
1999-05-31,"Europe",29,3839,975,390,5204
1999-05-31,"North America",2,368,250,46,664
1999-05-31,"Oceania",3,575,24,27,626
1999-05-31,"South America",7,582,203,65,850
1999-06-30,"Africa",17,1857,255,77,2189
1999-06-30,"Asia",14,2082,511,157,2750
1999-06-30,"Europe",29,3784,974,382,5140
1999-06-30,"North America",2,345,235,35,615
1999-06-30,"Oceania",3,596,25,23,644
1999-06-30,"South America",7,582,211,61,854
1999-07-31,"Africa",18,1857,270,83,2210
1999-07-31,"Asia",14,2085,652,189,2926
1999-07-31,"Europe",29,3785,1006,421,5212
1999-07-31,"North America",2,351,254,47,652
1999-07-31,"Oceania",3,595,25,29,649
1999-07-31,"South America",8,592,188,63,843
1999-08-31,"Africa",21,1947,336,93,2376
1999-08-31,"Asia",15,2110,680,190,2980
1999-08-31,"Europe",29,3696,1467,423,5586
1999-08-31,"North America",2,264,434,46,744
1999-08-31,"Oceania",3,611,120,30,761
1999-08-31,"South America",9,592,237,68,897
1999-09-30,"Africa",23,2073,372,130,2575
1999-09-30,"Asia",15,2089,836,270,3195
1999-09-30,"Europe",30,3644,1665,502,5811
1999-09-30,"North America",2,248,732,54,1034
1999-09-30,"Oceania",3,591,78,53,722
1999-09-30,"South America",9,581,240,89,910
1999-10-31,"Africa",24,1966,517,140,2623
1999-10-31,"Asia",15,2089,872,314,3275
1999-10-31,"Europe",30,3736,1781,524,6041
1999-10-31,"North America",2,216,724,52,992
1999-10-31,"Oceania",3,591,80,51,722
1999-10-31,"South America",9,581,264,100,945
1999-11-30,"Africa",24,1903,517,140,2560
1999-11-30,"Asia",15,2089,872,314,3275
1999-11-30,"Europe",30,3736,1781,524,6041
1999-11-30,"North America",2,216,724,52,992
1999-11-30,"Oceania",3,591,80,51,722
1999-11-30,"South America",9,581,264,100,945
1999-12-31,"Africa",24,4633,593,168,5394
1999-12-31,"Asia",15,2902,847,387,4136
1999-12-31,"Europe",30,3649,1865,505,6019
1999-12-31,"North America",2,193,785,53,1031
1999-12-31,"Oceania",3,595,123,59,777
1999-12-31,"South America",8,496,214,100,810
2000-01-31,"Africa",23,4262,623,192,5077
2000-01-31,"Asia",16,3508,993,387,4888
2000-01-31,"Europe",30,3658,1881,520,6059
2000-01-31,"North America",2,192,759,58,1009
2000-01-31,"Oceania",3,599,118,56,773
2000-01-31,"South America",9,490,238,106,834
2000-02-28,"Africa",23,4317,839,984,6140
2000-02-28,"Asia",16,6487,1150,399,8036
2000-02-28,"Europe",30,4456,2009,525,6990
2000-02-28,"North America",2,356,869,59,1284
2000-02-28,"Oceania",3,3154,153,58,3365
2000-02-28,"South America",9,579,239,107,925
2000-03-31,"Africa",22,6526,912,209,7647
2000-03-31,"Asia",16,7351,1701,409,9461
2000-03-31,"Europe",30,4457,2086,534,7077
2000-03-31,"North America",2,189,856,61,1106
2000-03-31,"Oceania",3,3087,151,57,3295
2000-03-31,"South America",9,597,120,114,831
2000-04-30,"Africa",23,7342,847,221,8410
2000-04-30,"Asia",16,8255,1975,410,10640
2000-04-30,"Europe",31,4547,2089,536,7172
2000-04-30,"North America",2,195,895,61,1151
2000-04-30,"Oceania",3,2994,151,61,3206
2000-04-30,"South America",10,597,147,115,859
2000-05-31,"Africa",24,7433,858,255,8546
2000-05-31,"Asia",16,11514,2421,445,14380
2000-05-31,"Europe",31,4478,2164,537,7179
2000-05-31,"North America",2,187,909,61,1157
2000-05-31,"Oceania",3,3278,147,57,3482
2000-05-31,"South America",11,597,120,126,843
2000-06-30,"Africa",25,7544,858,289,8691
2000-06-30,"Asia",16,12040,2520,439,14999
2000-06-30,"Europe",31,4744,2391,537,7672
2000-06-30,"North America",2,196,888,61,1145
2000-06-30,"Oceania",4,3042,179,57,3278
2000-06-30,"South America",11,599,129,123,851
2000-07-31,"Africa",25,7548,877,296,8721
2000-07-31,"Asia",16,12138,2558,428,15124
2000-07-31,"Europe",31,5380,2377,535,8292
2000-07-31,"North America",2,191,955,70,1216
2000-07-31,"Oceania",4,3042,175,57,3274
2000-07-31,"South America",11,600,114,125,839
2000-08-31,"Africa",25,7535,952,305,8792
2000-08-31,"Asia",16,11831,2656,405,14892
2000-08-31,"Europe",31,5495,2374,543,8412
2000-08-31,"North America",2,196,924,65,1185
2000-08-31,"Oceania",4,3063,186,58,3307
2000-08-31,"South America",11,621,109,124,854
2000-09-30,"Africa",23,7540,980,324,8844
2000-09-30,"Asia",16,11986,2762,407,15155
2000-09-30,"Europe",31,5546,2364,552,8462
2000-09-30,"North America",2,189,930,63,1182
2000-09-30,"Oceania",5,3027,222,58,3307
2000-09-30,"South America",11,618,109,126,853
2000-10-31,"Africa",24,7556,996,326,8878
2000-10-31,"Asia",16,11991,2826,379,15196
2000-10-31,"Europe",31,5527,2472,567,8566
2000-10-31,"North America",2,189,948,65,1202
2000-10-31,"Oceania",5,3047,213,56,3316
2000-10-31,"South America",11,621,75,130,826
2000-11-30,"Africa",24,7655,1038,313,9006
2000-11-30,"Asia",16,11942,2824,393,15159
2000-11-30,"Europe",31,5680,2660,566,8906
2000-11-30,"North America",2,245,988,69,1302
2000-11-30,"Oceania",4,3051,231,48,3330
2000-11-30,"South America",11,624,68,126,818
2000-12-31,"Africa",25,7669,1061,308,9038
2000-12-31,"Asia",16,9624,2847,364,12835
2000-12-31,"Europe",31,7155,2677,564,10396
2000-12-31,"North America",2,425,961,67,1453
2000-12-31,"Oceania",4,3046,127,56,3229
2000-12-31,"South America",11,618,55,122,795
2001-01-31,"Africa",24,7860,1147,302,9309
2001-01-31,"Asia",16,10366,2817,355,13538
2001-01-31,"Europe",31,7398,2679,561,10638
2001-01-31,"North America",2,437,949,73,1459
2001-01-31,"Oceania",4,3050,233,56,3339
2001-01-31,"South America",12,606,96,117,819
2001-02-28,"Africa",24,7860,1147,302,9309
2001-02-28,"Asia",16,10366,2817,355,13538
2001-02-28,"Europe",31,7398,2679,561,10638
2001-02-28,"North America",2,437,949,73,1459
2001-02-28,"Oceania",4,3050,233,56,3339
2001-02-28,"South America",12,606,96,117,819
2001-03-31,"Africa",25,8647,999,336,9982
2001-03-31,"Asia",16,12336,2653,386,15375
2001-03-31,"Europe",31,7420,2651,603,10674
2001-03-31,"North America",2,430,936,74,1440
2001-03-31,"Oceania",4,3087,215,56,3358
2001-03-31,"South America",12,608,96,121,825
2001-04-30,"Africa",24,9268,973,368,10609
2001-04-30,"Asia",16,12035,2682,404,15121
2001-04-30,"Europe",31,7535,2782,615,10932
2001-04-30,"North America",2,432,930,74,1436
2001-04-30,"Oceania",4,3115,218,56,3389
2001-04-30,"South America",11,840,196,131,1167
2001-05-31,"Africa",24,10173,945,410,11528
2001-05-31,"Asia",16,12634,2760,358,15752
2001-05-31,"Europe",31,7593,2698,604,10895
2001-05-31,"North America",2,418,917,70,1405
2001-05-31,"Oceania",4,2909,203,31,3143
2001-05-31,"South America",11,882,173,119,1174
2001-06-30,"Africa",24,10103,930,420,11453
2001-06-30,"Asia",16,12643,2782,419,15844
2001-06-30,"Europe",31,6610,2732,610,9952
2001-06-30,"North America",2,199,857,69,1125
2001-06-30,"Oceania",4,2901,220,56,3177
2001-06-30,"South America",11,1036,176,149,1361
2001-07-31,"Africa",23,10162,902,431,11495
2001-07-31,"Asia",16,14867,2785,419,18071
2001-07-31,"Europe",31,6299,2695,605,9599
2001-07-31,"North America",2,197,839,69,1105
2001-07-31,"Oceania",5,2881,245,54,3180
2001-07-31,"South America",10,1045,179,154,1378
2001-08-31,"Africa",23,10221,951,423,11595
2001-08-31,"Asia",16,17124,2718,430,20272
2001-08-31,"Europe",31,6274,2729,629,9632
2001-08-31,"North America",2,203,803,69,1075
2001-08-31,"Oceania",5,2932,245,55,3232
2001-08-31,"South America",10,1020,182,155,1357
2001-09-30,"Africa",23,10228,926,438,11592
2001-09-30,"Asia",16,17093,2828,432,20353
2001-09-30,"Europe",31,6209,2711,632,9552
2001-09-30,"North America",2,194,789,66,1049
2001-09-30,"Oceania",5,2877,234,50,3161
2001-09-30,"South America",10,1015,100,158,1273
2001-10-31,"Africa",22,10397,925,466,11788
2001-10-31,"Asia",16,17280,2782,449,20511
2001-10-31,"Europe",31,5973,2687,640,9300
2001-10-31,"North America",2,194,854,66,1114
2001-10-31,"Oceania",5,2663,237,50,2950
2001-10-31,"South America",10,1593,182,160,1935
2001-11-30,"Africa",22,10297,921,472,11690
2001-11-30,"Asia",16,17867,2788,458,21113
2001-11-30,"Europe",31,5508,2741,652,8901
2001-11-30,"North America",2,206,827,65,1098
2001-11-30,"Oceania",5,2857,196,49,3102
2001-11-30,"South America",10,1559,184,154,1897
2001-12-31,"Africa",22,10302,890,472,11664
2001-12-31,"Asia",16,17340,2777,433,20550
2001-12-31,"Europe",31,5408,2808,650,8866
2001-12-31,"North America",2,192,792,61,1045
2001-12-31,"Oceania",5,2864,197,50,3111
2001-12-31,"South America",10,1559,178,158,1895
2002-01-31,"Africa",22,10290,890,462,11642
2002-01-31,"Asia",16,16523,2745,442,19710
2002-01-31,"Europe",31,5485,2761,633,8879
2002-01-31,"North America",2,191,817,53,1061
2002-01-31,"Oceania",5,2861,165,51,3077
2002-01-31,"South America",10,1558,176,159,1893
2002-02-28,"Africa",22,10293,961,467,11721
2002-02-28,"Asia",16,16172,2665,453,19290
2002-02-28,"Europe",31,5464,2893,647,9004
2002-02-28,"North America",2,198,819,53,1070
2002-02-28,"Oceania",5,2885,182,51,3118
2002-02-28,"South America",10,1758,180,158,2096
2002-03-31,"Africa",22,10341,883,469,11693
2002-03-31,"Asia",16,16589,2665,461,19715
2002-03-31,"Europe",31,5417,2881,640,8938
2002-03-31,"North America",2,198,761,55,1014
2002-03-31,"Oceania",5,2814,181,51,3046
2002-03-31,"South America",10,1760,159,158,2077
2002-04-30,"Africa",21,10310,910,476,11696
2002-04-30,"Asia",16,16978,2605,456,20039
2002-04-30,"Europe",31,5225,2896,633,8754
2002-04-30,"North America",2,195,745,53,993
2002-04-30,"Oceania",5,3009,181,51,3241
2002-04-30,"South America",10,1758,182,159,2099
2002-05-31,"Africa",21,10313,891,480,11684
2002-05-31,"Asia",16,15896,2472,452,18820
2002-05-31,"Europe",31,5286,2805,625,8716
2002-05-31,"North America",2,197,718,51,966
2002-05-31,"Oceania",5,2740,184,48,2972
2002-05-31,"South America",11,1787,183,166,2136
2002-06-30,"Africa",21,10397,862,475,11734
2002-06-30,"Asia",16,15755,2450,459,18664
2002-06-30,"Europe",32,5138,2770,618,8526
2002-06-30,"North America",2,203,693,51,947
2002-06-30,"Oceania",5,2647,182,48,2877
2002-06-30,"South America",11,2262,196,162,2620
2002-07-31,"Africa",22,10380,831,454,11665
2002-07-31,"Asia",16,15749,2399,446,18594
2002-07-31,"Europe",32,4944,2658,629,8231
2002-07-31,"North America",2,201,708,49,958
2002-07-31,"Oceania",5,2454,150,51,2655
2002-07-31,"South America",11,2272,205,157,2634
2002-08-30,"Africa",23,10309,807,455,11571
2002-08-30,"Asia",17,15723,2214,461,18398
2002-08-30,"Europe",32,4898,2689,630,8217
2002-08-30,"North America",2,209,709,49,967
2002-08-30,"Oceania",5,2315,132,50,2497
2002-08-30,"South America",11,2244,203,163,2610
2002-09-30,"Africa",23,10337,781,443,11561
2002-09-30,"Asia",17,15773,2346,458,18577
2002-09-30,"Europe",32,4991,2655,616,8262
2002-09-30,"North America",2,200,660,49,909
2002-09-30,"Oceania",5,2251,132,58,2441
2002-09-30,"South America",11,2246,202,161,2609
2002-10-31,"Africa",23,10126,719,428,11273
2002-10-31,"Asia",17,15882,1986,468,18336
2002-10-31,"Europe",32,4724,2485,622,7831
2002-10-31,"North America",2,199,685,50,934
2002-10-31,"Oceania",4,1872,117,49,2038
2002-10-31,"South America",10,2252,189,154,2595
2002-11-30,"Africa",23,10071,673,428,11172
2002-11-30,"Asia",18,15379,2032,464,17875
2002-11-30,"Europe",32,4721,2485,619,7825
2002-11-30,"North America",2,199,685,51,935
2002-11-30,"Oceania",4,1306,117,49,1472
2002-11-30,"South America",10,2303,189,155,2647
2002-12-31,"Africa",23,10070,567,453,11090
2002-12-31,"Asia",18,14482,1938,476,16896
2002-12-31,"Europe",32,4415,1886,624,6925
2002-12-31,"North America",2,200,648,46,894
2002-12-31,"Oceania",4,1037,122,50,1209
2002-12-31,"South America",10,2316,172,150,2638
2003-01-31,"Africa",23,9938,569,452,10959
2003-01-31,"Asia",18,14099,1956,481,16536
2003-01-31,"Europe",32,4432,1889,620,6941
2003-01-31,"North America",2,200,629,43,872
2003-01-31,"Oceania",4,1026,121,50,1197
2003-01-31,"South America",10,2328,168,146,2642
2003-02-28,"Africa",24,9966,524,448,10938
2003-02-28,"Asia",18,14078,1944,478,16500
2003-02-28,"Europe",32,4361,1880,620,6861
2003-02-28,"North America",2,201,599,42,842
2003-02-28,"Oceania",4,1034,110,48,1192
2003-02-28,"South America",10,2353,167,148,2668
2003-03-30,"Africa",24,10036,566,457,11059
2003-03-30,"Asia",18,12342,1930,431,14703
2003-03-30,"Europe",32,4312,1859,536,6707
2003-03-30,"North America",2,201,618,33,852
2003-03-30,"Oceania",4,1019,110,36,1165
2003-03-30,"South America",9,2317,166,136,2619
2003-04-30,"Africa",24,10006,492,474,10972
2003-04-30,"Asia",18,12378,1937,429,14744
2003-04-30,"Europe",32,4295,1871,546,6712
2003-04-30,"North America",2,201,586,33,820
2003-04-30,"Oceania",4,987,110,38,1135
2003-04-30,"South America",9,2300,166,138,2604
2003-05-31,"Africa",24,8333,452,471,9256
2003-05-31,"Asia",18,12326,1837,435,14598
2003-05-31,"Europe",32,4336,1725,545,6606
2003-05-31,"North America",2,201,567,33,801
2003-05-31,"Oceania",4,1023,110,37,1170
2003-05-31,"South America",9,2205,163,148,2516
2003-06-30,"Africa",24,9631,417,488,10536
2003-06-30,"Asia",18,12346,1745,444,14535
2003-06-30,"Europe",32,4370,1716,546,6632
2003-06-30,"North America",2,200,557,28,785
2003-06-30,"Oceania",4,1020,106,37,1163
2003-06-30,"South America",9,2408,162,146,2716
2003-07-31,"Africa",24,9648,437,498,10583
2003-07-31,"Asia",18,12684,1719,446,14849
2003-07-31,"Europe",32,4376,1705,561,6642
2003-07-31,"North America",2,198,544,27,769
2003-07-31,"Oceania",4,983,105,33,1121
2003-07-31,"South America",9,2401,161,152,2714
2003-08-31,"Africa",24,8873,471,491,9835
2003-08-31,"Asia",18,13950,1583,446,15979
2003-08-31,"Europe",32,4630,1648,569,6847
2003-08-31,"North America",2,197,465,28,690
2003-08-31,"Oceania",4,1004,105,32,1141
2003-08-31,"South America",9,2405,160,145,2710
2003-09-30,"Africa",24,8860,467,480,9807
2003-09-30,"Asia",18,15182,1646,454,17282
2003-09-30,"Europe",32,4378,1645,564,6587
2003-09-30,"North America",2,197,444,28,669
2003-09-30,"Oceania",4,998,106,33,1137
2003-09-30,"South America",9,2525,121,142,2788
2003-10-31,"Africa",27,12690,500,485,13675
2003-10-31,"Asia",18,15582,1629,454,17665
2003-10-31,"Europe",32,4393,1625,568,6586
2003-10-31,"North America",2,198,477,28,703
2003-10-31,"Oceania",4,1000,86,34,1120
2003-10-31,"South America",9,2544,156,148,2848
2003-11-30,"Africa",27,12688,508,515,13711
2003-11-30,"Asia",17,16557,1222,470,18249
2003-11-30,"Europe",32,4772,1986,567,7325
2003-11-30,"North America",2,200,522,33,755
2003-11-30,"Oceania",4,570,72,34,676
2003-11-30,"South America",10,2495,158,162,2815
2003-12-31,"Africa",27,13721,525,569,14815
2003-12-31,"Asia",19,17559,1762,474,19795
2003-12-31,"Europe",32,4862,1595,576,7033
2003-12-31,"North America",2,194,521,36,751
2003-12-31,"Oceania",4,503,70,34,607
2003-12-31,"South America",10,2496,154,164,2814
2004-01-31,"Africa",27,14083,573,549,15205
2004-01-31,"Asia",19,19765,1850,465,22080
2004-01-31,"Europe",32,5045,1558,575,7178
2004-01-31,"North America",2,195,484,36,715
2004-01-31,"Oceania",4,494,58,34,586
2004-01-31,"South America",10,2500,156,170,2826
2004-02-28,"Africa",27,14866,543,545,15954
2004-02-28,"Asia",19,19831,1853,462,22146
2004-02-28,"Europe",32,4880,1522,580,6982
2004-02-28,"North America",2,206,503,35,744
2004-02-28,"Oceania",4,499,71,34,604
2004-02-28,"South America",10,2491,156,168,2815
2004-03-31,"Africa",27,15804,557,565,16926
2004-03-31,"Asia",19,20977,1871,481,23329
2004-03-31,"Europe",32,5077,1526,580,7183
2004-03-31,"North America",2,206,476,35,717
2004-03-31,"Oceania",4,501,71,34,606
2004-03-31,"South America",10,2610,155,171,2936
2004-04-30,"Africa",28,17149,612,594,18355
2004-04-30,"Asia",19,21122,1827,499,23448
2004-04-30,"Europe",32,5233,1536,603,7372
2004-04-30,"North America",2,200,554,35,789
2004-04-30,"Oceania",4,502,81,34,617
2004-04-30,"South America",11,2500,154,184,2838
2004-05-31,"Africa",29,18337,675,609,19621
2004-05-31,"Asia",19,21776,1850,503,24129
2004-05-31,"Europe",32,5356,1474,491,7321
2004-05-31,"North America",2,212,526,24,762
2004-05-31,"Oceania",4,418,128,10,556
2004-05-31,"South America",11,2745,164,172,3081
2004-06-30,"Africa",29,19246,840,662,20748
2004-06-30,"Asia",18,20102,2018,518,22638
2004-06-30,"Europe",32,4540,1627,599,6766
2004-06-30,"North America",2,700,502,31,1233
2004-06-30,"Oceania",4,244,114,29,387
2004-06-30,"South America",12,4156,150,183,4489
2004-07-31,"Africa",31,19931,1051,676,21658
2004-07-31,"Asia",18,21459,2102,527,24088
2004-07-31,"Europe",32,4532,1637,603,6772
2004-07-31,"North America",2,512,447,32,991
2004-07-31,"Oceania",4,231,117,27,375
2004-07-31,"South America",13,4526,162,184,4872
2004-08-31,"Africa",31,19509,1051,718,21278
2004-08-31,"Asia",18,23313,2102,533,25948
2004-08-31,"Europe",32,4534,1637,595,6766
2004-08-31,"North America",2,216,447,32,695
2004-08-31,"Oceania",4,231,117,27,375
2004-08-31,"South America",13,5327,162,194,5683
2004-09-30,"Africa",33,19611,1233,741,21585
2004-09-30,"Asia",18,24213,2300,559,27072
2004-09-30,"Europe",32,4526,1702,581,6809
2004-09-30,"North America",2,208,409,32,649
2004-09-30,"Oceania",4,233,119,27,379
2004-09-30,"South America",13,5409,206,198,5813
2004-10-31,"Africa",33,19703,1364,734,21801
2004-10-31,"Asia",19,23838,2596,522,26956
2004-10-31,"Europe",32,4728,1747,610,7085
2004-10-31,"North America",2,205,436,32,673
2004-10-31,"Oceania",4,234,119,27,380
2004-10-31,"South America",13,5478,224,193,5895
2004-11-30,"Africa",33,20139,1368,730,22237
2004-11-30,"Asia",19,23984,2870,507,27361
2004-11-30,"Europe",32,4723,1752,610,7085
2004-11-30,"North America",2,215,427,31,673
2004-11-30,"Oceania",4,227,119,28,374
2004-11-30,"South America",13,5787,230,181,6198
2004-12-31,"Africa",33,19230,1310,676,21216
2004-12-31,"Asia",18,26041,2889,523,29453
2004-12-31,"Europe",32,4368,1722,602,6692
2004-12-31,"North America",2,204,510,29,743
2004-12-31,"Oceania",4,232,117,28,377
2004-12-31,"South America",13,5834,220,188,6242
2005-01-31,"Africa",33,18665,1307,714,20686
2005-01-31,"Asia",19,27228,2889,523,30640
2005-01-31,"Europe",32,4130,1722,606,6458
2005-01-31,"North America",2,202,510,30,742
2005-01-31,"Oceania",4,232,117,29,378
2005-01-31,"South America",13,5740,220,186,6146
2005-02-28,"Africa",33,18594,1320,713,20627
2005-02-28,"Asia",19,29683,2855,521,33059
2005-02-28,"Europe",32,3814,1663,611,6088
2005-02-28,"North America",2,212,453,33,698
2005-02-28,"Oceania",4,229,114,31,374
2005-02-28,"South America",13,5675,222,187,6084
2005-03-31,"Africa",33,18587,1342,716,20645
2005-03-31,"Asia",19,29744,2659,536,32939
2005-03-31,"Europe",32,3674,1688,609,5971
2005-03-31,"North America",2,216,441,29,686
2005-03-31,"Oceania",4,234,114,31,379
2005-03-31,"South America",13,6116,222,185,6523
2005-04-30,"Africa",33,18603,1302,700,20605
2005-04-30,"Asia",19,29655,2451,531,32637
2005-04-30,"Europe",32,3691,1620,538,5849
2005-04-30,"North America",2,210,455,25,690
2005-04-30,"Oceania",4,234,82,28,344
2005-04-30,"South America",13,5966,221,186,6373
2005-05-31,"Africa",34,18397,1298,732,20427
2005-05-31,"Asia",20,29923,2388,539,32850
2005-05-31,"Europe",32,3796,1469,496,5761
2005-05-31,"North America",2,212,440,28,680
2005-05-31,"Oceania",4,3,54,20,77
2005-05-31,"South America",13,5663,229,201,6093
2005-06-30,"Africa",34,18464,1294,740,20498
2005-06-30,"Asia",20,30644,2388,563,33595
2005-06-30,"Europe",32,3840,1470,505,5815
2005-06-30,"North America",2,217,440,25,682
2005-06-30,"Oceania",4,3,54,24,81
2005-06-30,"South America",13,5670,227,216,6113
2005-07-31,"Africa",35,18535,1433,716,20684
2005-07-31,"Asia",20,30979,2306,562,33847
2005-07-31,"Europe",32,3912,1515,486,5913
2005-07-31,"North America",2,218,406,17,641
2005-07-31,"Oceania",4,3,93,14,110
2005-07-31,"South America",13,5677,238,209,6124
2005-08-31,"Africa",35,18394,1433,717,20544
2005-08-31,"Asia",20,31454,2283,548,34285
2005-08-31,"Europe",32,3924,1506,489,5919
2005-08-31,"North America",2,223,406,16,645
2005-08-31,"Oceania",4,3,86,23,112
2005-08-31,"South America",13,5674,236,210,6120
2005-09-30,"Africa",35,18397,1494,707,20598
2005-09-30,"Asia",20,31960,2486,543,34989
2005-09-30,"Europe",32,3782,1548,492,5822
2005-09-30,"North America",2,217,439,21,677
2005-09-30,"Oceania",5,3,92,15,110
2005-09-30,"South America",13,5855,108,209,6172
2005-10-31,"Africa",34,18656,1537,815,21008
2005-10-31,"Asia",20,32865,2503,621,35989
2005-10-31,"Europe",32,3704,1534,623,5861
2005-10-31,"North America",2,208,515,45,768
2005-10-31,"Oceania",6,5,98,37,140
2005-10-31,"South America",13,5668,110,248,6026
2005-11-30,"Africa",34,18072,1676,824,20572
2005-11-30,"Asia",20,32949,3039,669,36657
2005-11-30,"Europe",32,3721,1527,532,5780
2005-11-30,"North America",2,222,498,44,764
2005-11-30,"Oceania",6,10,104,17,131
2005-11-30,"South America",13,5658,119,274,6051
2005-12-31,"Africa",34,18064,1938,836,20838
2005-12-31,"Asia",21,32655,3051,683,36389
2005-12-31,"Europe",32,3444,1537,524,5505
2005-12-31,"North America",2,221,495,55,771
2005-12-31,"Oceania",6,10,105,30,145
2005-12-31,"South America",13,5676,115,291,6082
2006-01-31,"Africa",34,18195,2040,879,21114
2006-01-31,"Asia",20,33901,3142,740,37783
2006-01-31,"Europe",32,3460,1491,666,5617
2006-01-31,"North America",2,204,475,61,740
2006-01-31,"Oceania",6,144,107,39,290
2006-01-31,"South America",13,5844,116,307,6267
2006-02-28,"Africa",34,17347,2085,854,20286
2006-02-28,"Asia",20,35842,3230,765,39837
2006-02-28,"Europe",32,3482,1508,683,5673
2006-02-28,"North America",2,206,458,60,724
2006-02-28,"Oceania",6,144,107,39,290
2006-02-28,"South America",13,5787,134,303,6224
2006-03-31,"Africa",35,16354,2067,892,19313
2006-03-31,"Asia",20,36102,3236,748,40086
2006-03-31,"Europe",32,3165,1502,689,5356
2006-03-31,"North America",2,26,453,59,538
2006-03-31,"Oceania",6,144,117,44,305
2006-03-31,"South America",13,5800,126,299,6225
2006-04-30,"Africa",35,17692,2090,887,20669
2006-04-30,"Asia",20,36060,3262,748,40070
2006-04-30,"Europe",32,3079,1495,669,5243
2006-04-30,"North America",2,28,398,52,478
2006-04-30,"Oceania",6,144,116,44,304
2006-04-30,"South America",14,5653,121,298,6072
2006-05-31,"Africa",35,17759,2076,875,20710
2006-05-31,"Asia",20,36435,3289,758,40482
2006-05-31,"Europe",32,3083,1479,660,5222
2006-05-31,"North America",2,26,358,48,432
2006-05-31,"Oceania",5,143,71,41,255
2006-05-31,"South America",14,5653,125,297,6075
2006-06-30,"Africa",35,17773,2096,880,20749
2006-06-30,"Asia",20,36113,3169,729,40011
2006-06-30,"Europe",32,3117,1419,602,5138
2006-06-30,"North America",2,27,390,59,476
2006-06-30,"Oceania",5,144,79,36,259
2006-06-30,"South America",14,5771,112,283,6166
2006-07-31,"Africa",35,17813,2039,886,20738
2006-07-31,"Asia",20,36080,3181,753,40014
2006-07-31,"Europe",32,3150,1433,591,5174
2006-07-31,"North America",2,30,386,51,467
2006-07-31,"Oceania",5,144,78,35,257
2006-07-31,"South America",14,5809,129,302,6240
2006-08-31,"Africa",35,17712,2035,893,20640
2006-08-31,"Asia",20,36960,3637,749,41346
2006-08-31,"Europe",32,3351,1571,589,5511
2006-08-31,"North America",2,24,388,55,467
2006-08-31,"Oceania",5,233,296,37,566
2006-08-31,"South America",14,5756,119,300,6175
2006-09-30,"Africa",35,17703,2064,884,20651
2006-09-30,"Asia",21,36153,3604,760,40517
2006-09-30,"Europe",32,6226,1572,652,8450
2006-09-30,"North America",2,22,377,55,454
2006-09-30,"Oceania",5,233,208,45,486
2006-09-30,"South America",15,5972,122,300,6394
2006-10-31,"Africa",35,17706,2120,881,20707
2006-10-31,"Asia",21,36637,4035,723,41395
2006-10-31,"Europe",34,9152,1632,634,11418
2006-10-31,"North America",2,22,346,54,422
2006-10-31,"Oceania",5,233,227,49,509
2006-10-31,"South America",15,5982,116,299,6397
2006-11-30,"Africa",35,17695,2109,862,20666
2006-11-30,"Asia",21,36650,4056,741,41447
2006-11-30,"Europe",35,10175,1619,685,12479
2006-11-30,"North America",2,26,376,58,460
2006-11-30,"Oceania",5,234,210,49,493
2006-11-30,"South America",15,5980,112,283,6375
2006-12-31,"Africa",35,15594,2120,769,18483
2006-12-31,"Asia",22,36807,4180,722,41709
2006-12-31,"Europe",35,10475,1697,663,12835
2006-12-31,"North America",2,24,383,49,456
2006-12-31,"Oceania",5,233,201,47,481
2006-12-31,"South America",15,6013,114,277,6404
2007-01-31,"Africa",34,16115,2339,750,19204
2007-01-31,"Asia",23,37526,4486,713,42725
2007-01-31,"Europe",35,10335,1686,679,12700
2007-01-31,"North America",2,24,375,58,457
2007-01-31,"Oceania",5,233,210,47,490
2007-01-31,"South America",15,6019,112,285,6416
2007-02-28,"Africa",34,16227,2393,754,19374
2007-02-28,"Asia",23,37886,4629,736,43251
2007-02-28,"Europe",35,10317,1714,683,12714
2007-02-28,"North America",2,23,377,58,458
2007-02-28,"Oceania",5,234,209,45,488
2007-02-28,"South America",15,6028,122,316,6466
2007-03-31,"Africa",36,16139,2446,773,19358
2007-03-31,"Asia",22,38229,4660,754,43643
2007-03-31,"Europe",35,10202,1764,688,12654
2007-03-31,"North America",2,23,380,57,460
2007-03-31,"Oceania",5,233,209,46,488
2007-03-31,"South America",15,6013,137,318,6468
2007-04-30,"Africa",36,16154,2388,780,19322
2007-04-30,"Asia",22,38160,4701,774,43635
2007-04-30,"Europe",35,10436,1784,702,12922
2007-04-30,"North America",2,23,358,58,439
2007-04-30,"Oceania",6,233,205,46,484
2007-04-30,"South America",14,6027,129,319,6475
2007-05-31,"Africa",36,16159,2407,791,19357
2007-05-31,"Asia",24,38695,4678,797,44170
2007-05-31,"Europe",35,9927,1774,700,12401
2007-05-31,"North America",2,24,365,57,446
2007-05-31,"Oceania",6,233,198,51,482
2007-05-31,"South America",14,6026,129,313,6468
2007-06-30,"Africa",36,16215,2441,802,19458
2007-06-30,"Asia",24,38729,4807,796,44332
2007-06-30,"Europe",35,9953,1766,698,12417
2007-06-30,"North America",2,24,365,56,445
2007-06-30,"Oceania",6,232,190,46,468
2007-06-30,"South America",14,6042,129,325,6496
2007-07-31,"Africa",36,16194,2405,811,19410
2007-07-31,"Asia",24,38925,4780,806,44511
2007-07-31,"Europe",35,10008,1759,708,12475
2007-07-31,"North America",2,24,351,57,432
2007-07-31,"Oceania",6,233,185,46,464
2007-07-31,"South America",14,6044,122,325,6491
2007-08-31,"Africa",37,16205,2370,768,19343
2007-08-31,"Asia",24,38931,4593,781,44305
2007-08-31,"Europe",35,9857,1746,690,12293
2007-08-31,"North America",2,25,353,55,433
2007-08-31,"Oceania",6,233,183,47,463
2007-08-31,"South America",15,6041,135,315,6491
2007-09-30,"Africa",37,16201,2362,780,19343
2007-09-30,"Asia",24,38932,4725,815,44472
2007-09-30,"Europe",35,9757,1767,693,12217
2007-09-30,"North America",2,25,356,57,438
2007-09-30,"Oceania",6,233,188,47,468
2007-09-30,"South America",15,6038,139,331,6508
2007-10-31,"Africa",37,15593,2359,788,18740
2007-10-31,"Asia",24,38924,4682,804,44410
2007-10-31,"Europe",35,9756,1661,678,12095
2007-10-31,"North America",2,23,396,58,477
2007-10-31,"Oceania",6,241,176,46,463
2007-10-31,"South America",15,6043,140,333,6516
2007-11-30,"Africa",37,15584,2408,808,18800
2007-11-30,"Asia",24,38946,4830,797,44573
2007-11-30,"Europe",35,9793,1697,690,12180
2007-11-30,"North America",2,23,413,59,495
2007-11-30,"Oceania",6,233,173,46,452
2007-11-30,"South America",15,6040,137,329,6506
2007-12-31,"Africa",39,15554,3839,803,20196
2007-12-31,"Asia",23,38918,4844,805,44567
2007-12-31,"Europe",35,9758,1708,686,12152
2007-12-31,"North America",2,23,383,59,465
2007-12-31,"Oceania",5,233,171,44,448
2007-12-31,"South America",15,6022,132,327,6481
2008-01-31,"Africa",40,22452,3890,1008,27350
2008-01-31,"Asia",23,38883,4919,793,44595
2008-01-31,"Europe",34,9116,1719,677,11512
2008-01-31,"North America",2,31,402,55,488
2008-01-31,"Oceania",6,233,185,44,462
2008-01-31,"South America",14,6037,139,300,6476
2008-02-28,"Africa",39,22354,3989,1011,27354
2008-02-28,"Asia",22,38213,4962,815,43990
2008-02-28,"Europe",35,9486,1730,679,11895
2008-02-28,"North America",2,33,391,60,484
2008-02-28,"Oceania",6,230,194,45,469
2008-02-28,"South America",14,6035,152,311,6498
2008-03-31,"Africa",39,22319,3966,863,27148
2008-03-31,"Asia",22,36878,5012,768,42658
2008-03-31,"Europe",35,9262,1676,673,11611
2008-03-31,"North America",2,35,372,59,466
2008-03-31,"Oceania",6,229,194,40,463
2008-03-31,"South America",14,6065,150,301,6516
2008-04-30,"Africa",39,22148,3884,862,26894
2008-04-30,"Asia",22,36899,4952,778,42629
2008-04-30,"Europe",35,9264,1718,682,11664
2008-04-30,"North America",2,34,378,59,471
2008-04-30,"Oceania",5,230,189,44,463
2008-04-30,"South America",14,6082,145,306,6533
2008-05-31,"Africa",39,21888,3938,842,26668
2008-05-31,"Asia",22,36613,4990,763,42366
2008-05-31,"Europe",35,9431,1721,675,11827
2008-05-31,"North America",2,32,367,58,457
2008-05-31,"Oceania",5,230,200,44,474
2008-05-31,"South America",14,6154,152,320,6626
2008-06-30,"Africa",39,21969,3993,859,26821
2008-06-30,"Asia",23,36620,5211,749,42580
2008-06-30,"Europe",36,9354,1701,668,11723
2008-06-30,"North America",2,31,336,59,426
2008-06-30,"Oceania",5,233,193,45,471
2008-06-30,"South America",14,6047,149,300,6496
2008-07-31,"Africa",39,22029,3882,818,26729
2008-07-31,"Asia",23,36836,5271,728,42835
2008-07-31,"Europe",36,9323,1704,643,11670
2008-07-31,"North America",2,27,337,55,419
2008-07-31,"Oceania",5,233,190,47,470
2008-07-31,"South America",14,6087,133,291,6511
2008-08-31,"Africa",39,22303,3899,793,26995
2008-08-31,"Asia",23,36748,5226,735,42709
2008-08-31,"Europe",36,9184,1673,603,11460
2008-08-31,"North America",2,29,401,55,485
2008-08-31,"Oceania",5,236,186,47,469
2008-08-31,"South America",14,6017,134,307,6458
2008-09-30,"Africa",38,22183,3993,787,26963
2008-09-30,"Asia",23,36801,5272,773,42846
2008-09-30,"Europe",36,9346,1590,608,11544
2008-09-30,"North America",2,31,383,55,469
2008-09-30,"Oceania",5,232,158,44,434
2008-09-30,"South America",13,6063,133,302,6498
2008-10-31,"Africa",38,22507,3960,802,27269
2008-10-31,"Asia",25,37387,5864,783,44034
2008-10-31,"Europe",36,9316,1591,607,11514
2008-10-31,"North America",2,34,391,50,475
2008-10-31,"Oceania",5,243,184,41,468
2008-10-31,"South America",13,6025,135,323,6483
2008-11-30,"Africa",38,22587,4096,819,27502
2008-11-30,"Asia",25,37313,5840,770,43923
2008-11-30,"Europe",36,9310,1126,593,11029
2008-11-30,"North America",2,29,303,55,387
2008-11-30,"Oceania",6,240,178,46,464
2008-11-30,"South America",13,6082,132,326,6540
2008-12-31,"Africa",38,24461,4334,843,29638
2008-12-31,"Asia",25,38002,5771,783,44556
2008-12-31,"Europe",35,8739,884,585,10208
2008-12-31,"North America",2,34,184,52,270
2008-12-31,"Oceania",6,240,186,47,473
2008-12-31,"South America",14,6075,152,320,6547
2009-01-31,"Africa",38,24606,4185,832,29623
2009-01-31,"Asia",25,38077,5345,752,44174
2009-01-31,"Europe",35,8975,751,570,10296
2009-01-31,"North America",2,33,183,53,269
2009-01-31,"Oceania",6,241,187,45,473
2009-01-31,"South America",14,6095,134,318,6547
2009-02-28,"Africa",38,24596,4038,817,29451
2009-02-28,"Asia",25,37618,5368,757,43743
2009-02-28,"Europe",35,8852,722,568,10142
2009-02-28,"North America",2,32,185,51,268
2009-02-28,"Oceania",6,238,192,45,475
2009-02-28,"South America",14,6103,124,299,6526
2009-03-31,"Africa",36,25081,3791,816,29688
2009-03-31,"Asia",25,37531,5309,732,43572
2009-03-31,"Europe",35,10378,702,571,11651
2009-03-31,"North America",2,34,206,52,292
2009-03-31,"Oceania",6,238,191,45,474
2009-03-31,"South America",14,6108,129,282,6519
2009-04-30,"Africa",36,25607,3769,783,30159
2009-04-30,"Asia",24,37371,5305,734,43410
2009-04-30,"Europe",35,10551,702,557,11810
2009-04-30,"North America",2,35,194,51,280
2009-04-30,"Oceania",6,230,192,45,467
2009-04-30,"South America",14,6086,136,287,6509
2009-05-31,"Africa",36,25928,3939,765,30632
2009-05-31,"Asia",24,37732,5792,738,44262
2009-05-31,"Europe",35,10379,679,552,11610
2009-05-31,"North America",2,32,196,50,278
2009-05-31,"Oceania",6,226,178,45,449
2009-05-31,"South America",14,6147,155,280,6582
2009-06-30,"Africa",36,25844,3890,732,30466
2009-06-30,"Asia",25,37935,5894,692,44521
2009-06-30,"Europe",35,9754,665,478,10897
2009-06-30,"North America",2,25,195,49,269
2009-06-30,"Oceania",6,233,179,45,457
2009-06-30,"South America",14,6153,170,283,6606
2009-07-31,"Africa",36,26071,4114,746,30931
2009-07-31,"Asia",25,36571,6104,694,43369
2009-07-31,"Europe",35,9810,670,487,10967
2009-07-31,"North America",2,27,197,47,271
2009-07-31,"Oceania",6,233,220,43,496
2009-07-31,"South America",14,6214,177,285,6676
2009-08-31,"Africa",36,27290,4472,763,32525
2009-08-31,"Asia",24,37357,6479,696,44532
2009-08-31,"Europe",35,9854,688,489,11031
2009-08-31,"North America",2,27,186,45,258
2009-08-31,"Oceania",6,233,217,43,493
2009-08-31,"South America",13,6145,170,265,6580
2009-09-30,"Africa",36,27592,4459,717,32768
2009-09-30,"Asia",24,37521,6487,697,44705
2009-09-30,"Europe",35,10062,698,482,11242
2009-09-30,"North America",2,27,188,47,262
2009-09-30,"Oceania",6,232,217,42,491
2009-09-30,"South America",13,6161,173,273,6607
2009-10-31,"Africa",37,27933,4556,731,33220
2009-10-31,"Asia",24,38711,6845,695,46251
2009-10-31,"Europe",34,9598,667,487,10752
2009-10-31,"North America",2,27,186,47,260
2009-10-31,"Oceania",6,240,212,41,493
2009-10-31,"South America",13,6147,179,268,6594
2009-11-30,"Africa",36,28374,4282,771,33427
2009-11-30,"Asia",24,39182,7172,719,47073
2009-11-30,"Europe",34,9118,683,487,10288
2009-11-30,"North America",2,28,177,55,260
2009-11-30,"Oceania",6,231,212,41,484
2009-11-30,"South America",13,6130,174,277,6581
2009-12-31,"Africa",35,29285,4453,747,34485
2009-12-31,"Asia",24,39238,7118,712,47068
2009-12-31,"Europe",34,8179,731,489,9399
2009-12-31,"North America",2,28,170,47,245
2009-12-31,"Oceania",6,231,157,43,431
2009-12-31,"South America",14,6125,165,276,6566
2010-01-31,"Africa",35,29649,4475,769,34893
2010-01-31,"Asia",24,40267,7199,699,48165
2010-01-31,"Europe",34,8329,723,499,9551
2010-01-31,"North America",2,28,145,49,222
2010-01-31,"Oceania",6,231,141,44,416
2010-01-31,"South America",14,6127,184,288,6599
2010-02-28,"Africa",34,30567,4502,779,35848
2010-02-28,"Asia",24,40347,7132,693,48172
2010-02-28,"Europe",35,7969,777,497,9243
2010-02-28,"North America",2,27,171,48,246
2010-02-28,"Oceania",6,230,190,44,464
2010-02-28,"South America",14,6126,161,287,6574
2010-03-31,"Africa",34,30465,4503,753,35721
2010-03-31,"Asia",24,40751,7167,704,48622
2010-03-31,"Europe",35,7900,850,488,9238
2010-03-31,"North America",2,41,170,45,256
2010-03-31,"Oceania",6,231,193,44,468
2010-03-31,"South America",14,7070,171,280,7521
2010-04-30,"Africa",34,30806,4644,757,36207
2010-04-30,"Asia",24,40051,7197,688,47936
2010-04-30,"Europe",35,8091,845,489,9425
2010-04-30,"North America",2,38,161,47,246
2010-04-30,"Oceania",6,231,188,45,464
2010-04-30,"South America",14,7143,186,278,7607
2010-05-31,"Africa",34,30965,4747,761,36473
2010-05-31,"Asia",24,40183,7201,708,48092
2010-05-31,"Europe",36,7406,961,497,8864
2010-05-31,"North America",2,41,181,47,269
2010-05-31,"Oceania",6,231,187,44,462
2010-05-31,"South America",14,7296,160,272,7728
2010-06-30,"Africa",35,30550,4420,781,35751
2010-06-30,"Asia",25,39879,7554,701,48134
2010-06-30,"Europe",35,6630,975,503,8108
2010-06-30,"North America",2,42,214,48,304
2010-06-30,"Oceania",6,231,187,44,462
2010-06-30,"South America",14,7452,162,272,7886
2010-07-31,"Africa",35,29473,4725,763,34961
2010-07-31,"Asia",25,40058,7533,704,48295
2010-07-31,"Europe",34,6851,890,494,8235
2010-07-31,"North America",2,40,188,48,276
2010-07-31,"Oceania",6,231,146,44,421
2010-07-31,"South America",14,7246,166,279,7691
2010-08-31,"Africa",35,29336,4837,762,34935
2010-08-31,"Asia",26,39978,7770,698,48446
2010-08-31,"Europe",34,6677,835,490,8002
2010-08-31,"North America",2,40,216,52,308
2010-08-31,"Oceania",5,231,139,45,415
2010-08-31,"South America",14,7369,173,274,7816
2010-09-30,"Africa",35,29286,4844,765,34895
2010-09-30,"Asia",26,40133,7772,683,48588
2010-09-30,"Europe",34,6793,830,493,8116
2010-09-30,"North America",2,39,193,50,282
2010-09-30,"Oceania",5,232,142,45,419
2010-09-30,"South America",14,7181,194,270,7645
2010-10-31,"Africa",37,29269,4816,781,34866
2010-10-31,"Asia",24,39625,7820,715,48160
2010-10-31,"Europe",34,6815,864,493,8172
2010-10-31,"North America",2,42,194,48,284
2010-10-31,"Oceania",5,231,144,45,420
2010-10-31,"South America",14,7134,199,271,7604
2010-11-30,"Africa",37,29125,4843,776,34744
2010-11-30,"Asia",26,39686,7693,732,48111
2010-11-30,"Europe",34,6747,844,494,8085
2010-11-30,"North America",2,34,204,48,286
2010-11-30,"Oceania",5,231,147,45,423
2010-11-30,"South America",14,7135,200,246,7581
2010-12-31,"Africa",36,28646,5156,751,34553
2010-12-31,"Asia",25,39444,7952,713,48109
2010-12-31,"Europe",33,6430,665,490,7585
2010-12-31,"North America",2,34,203,48,285
2010-12-31,"Oceania",5,232,149,44,425
2010-12-31,"South America",14,7228,197,256,7681
2011-01-31,"Africa",36,28640,5226,743,34609
2011-01-31,"Asia",25,39432,7927,686,48045
2011-01-31,"Europe",33,6443,653,476,7572
2011-01-31,"North America",2,38,232,52,322
2011-01-31,"Oceania",5,232,151,46,429
2011-01-31,"South America",14,7404,188,261,7853
2011-02-28,"Africa",36,28749,5278,731,34758
2011-02-28,"Asia",24,39693,8036,691,48420
2011-02-28,"Europe",33,6358,664,454,7476
2011-02-28,"North America",2,36,224,53,313
2011-02-28,"Oceania",5,232,142,45,419
2011-02-28,"South America",14,7292,182,252,7726
2011-03-31,"Africa",36,28859,5438,735,35032
2011-03-31,"Asia",24,39532,8058,680,48270
2011-03-31,"Europe",33,6394,661,464,7519
2011-03-31,"North America",2,36,224,52,312
2011-03-31,"Oceania",5,231,142,46,419
2011-03-31,"South America",14,7238,180,251,7669
2011-04-30,"Africa",36,29211,5432,717,35360
2011-04-30,"Asia",24,39332,8040,689,48061
2011-04-30,"Europe",34,6445,645,457,7547
2011-04-30,"North America",2,38,231,54,323
2011-04-30,"Oceania",5,230,148,46,424
2011-04-30,"South America",14,7226,173,251,7650
2011-05-31,"Africa",36,29222,5329,738,35289
2011-05-31,"Asia",23,39391,7837,682,47910
2011-05-31,"Europe",34,6327,634,452,7413
2011-05-31,"North America",2,34,239,50,323
2011-05-31,"Oceania",5,231,141,46,418
2011-05-31,"South America",14,7223,169,247,7639
2011-06-30,"Africa",35,29756,5156,722,35634
2011-06-30,"Asia",23,39370,7904,670,47944
2011-06-30,"Europe",36,6783,628,468,7879
2011-06-30,"North America",2,34,235,48,317
2011-06-30,"Oceania",5,233,138,46,417
2011-06-30,"South America",14,7223,145,255,7623
2011-07-31,"Africa",34,29586,4870,653,35109
2011-07-31,"Asia",23,39407,7739,566,47712
2011-07-31,"Europe",36,6847,550,371,7768
2011-07-31,"North America",2,27,217,28,272
2011-07-31,"Oceania",5,278,115,31,424
2011-07-31,"South America",14,7217,136,181,7534
2011-08-31,"Africa",34,31167,5156,790,37113
2011-08-31,"Asia",24,37815,7813,660,46288
2011-08-31,"Europe",35,6670,583,424,7677
2011-08-31,"North America",2,30,231,36,297
2011-08-31,"Oceania",5,286,128,45,459
2011-08-31,"South America",14,7209,151,224,7584
2011-09-30,"Africa",35,31105,5327,817,37249
2011-09-30,"Asia",23,37556,7885,613,46054
2011-09-30,"Europe",35,6855,580,418,7853
2011-09-30,"North America",2,35,254,31,320
2011-09-30,"Oceania",5,287,127,44,458
2011-09-30,"South America",14,7196,137,211,7544
2011-10-31,"Africa",35,30719,5189,729,36637
2011-10-31,"Asia",24,37942,7941,597,46480
2011-10-31,"Europe",34,6858,543,414,7815
2011-10-31,"North America",2,35,273,34,342
2011-10-31,"Oceania",5,293,130,44,467
2011-10-31,"South America",14,7181,163,209,7553
2011-11-30,"Africa",34,30663,5229,727,36619
2011-11-30,"Asia",25,37681,7971,582,46234
2011-11-30,"Europe",34,6272,563,406,7241
2011-11-30,"North America",2,29,262,29,320
2011-11-30,"Oceania",6,289,134,43,466
2011-11-30,"South America",14,7422,147,199,7768
2011-12-31,"Africa",33,31754,5205,725,37684
2011-12-31,"Asia",25,37143,7996,589,45728
2011-12-31,"Europe",34,6123,546,402,7071
2011-12-31,"North America",2,30,258,28,316
2011-12-31,"Oceania",6,331,132,42,505
2011-12-31,"South America",14,7349,165,198,7712
2012-01-31,"Africa",34,31800,5330,729,37859
2012-01-31,"Asia",25,36890,8046,595,45531
2012-01-31,"Europe",34,6149,558,412,7119
2012-01-31,"North America",2,34,262,30,326
2012-01-31,"Oceania",6,331,131,42,504
2012-01-31,"South America",14,7333,167,188,7688
2012-02-28,"Africa",35,31769,5257,759,37785
2012-02-28,"Asia",27,36806,8083,615,45504
2012-02-28,"Europe",34,6145,573,407,7125
2012-02-28,"North America",2,36,261,29,326
2012-02-28,"Oceania",6,333,139,40,512
2012-02-28,"South America",14,7322,163,189,7674
2012-03-31,"Africa",35,31802,5246,781,37829
2012-03-31,"Asia",26,37048,8063,620,45731
2012-03-31,"Europe",34,6023,581,396,7000
2012-03-31,"North America",2,35,234,30,299
2012-03-31,"Oceania",6,334,137,42,513
2012-03-31,"South America",14,7264,165,188,7617
2012-04-30,"Africa",35,32421,5174,771,38366
2012-04-30,"Asia",26,36784,8070,619,45473
2012-04-30,"Europe",34,6132,580,398,7110
2012-04-30,"North America",2,32,234,26,292
2012-04-30,"Oceania",6,331,126,38,495
2012-04-30,"South America",14,6956,156,184,7296
2012-05-31,"Africa",36,32589,5134,861,38584
2012-05-31,"Asia",26,36378,8247,683,45308
2012-05-31,"Europe",33,5999,602,466,7067
2012-05-31,"North America",2,34,234,33,301
2012-05-31,"Oceania",6,334,134,50,518
2012-05-31,"South America",14,6964,146,212,7322
2012-06-30,"Africa",37,32529,5176,849,38554
2012-06-30,"Asia",26,35847,7804,729,44380
2012-06-30,"Europe",35,5776,599,451,6826
2012-06-30,"North America",2,33,231,30,294
2012-06-30,"Oceania",6,285,134,47,466
2012-06-30,"South America",14,6973,154,210,7337
2012-07-31,"Africa",37,32648,4675,804,38127
2012-07-31,"Asia",26,35684,7768,652,44104
2012-07-31,"Europe",35,5634,593,421,6648
2012-07-31,"North America",2,35,236,32,303
2012-07-31,"Oceania",6,287,130,43,460
2012-07-31,"South America",13,6959,151,187,7297
2012-08-31,"Africa",35,32257,4716,740,37713
2012-08-31,"Asia",25,36075,7663,614,44352
2012-08-31,"Europe",34,5599,602,405,6606
2012-08-31,"North America",2,34,233,31,298
2012-08-31,"Oceania",6,293,133,38,464
2012-08-31,"South America",13,6957,146,186,7289
2012-09-30,"Africa",35,32054,4785,763,37602
2012-09-30,"Asia",26,36665,7681,605,44951
2012-09-30,"Europe",34,5610,590,395,6595
2012-09-30,"North America",2,30,234,30,294
2012-09-30,"Oceania",6,293,124,39,456
2012-09-30,"South America",13,6971,136,194,7301
2012-10-31,"Africa",35,31859,5005,747,37611
2012-10-31,"Asia",26,36701,7568,604,44873
2012-10-31,"Europe",33,5860,575,392,6827
2012-10-31,"North America",2,28,230,27,285
2012-10-31,"Oceania",6,250,124,39,413
2012-10-31,"South America",13,6973,133,191,7297
2012-11-30,"Africa",35,31872,4987,747,37606
2012-11-30,"Asia",25,36375,6840,612,43827
2012-11-30,"Europe",33,5417,397,400,6214
2012-11-30,"North America",2,31,224,27,282
2012-11-30,"Oceania",5,231,79,35,345
2012-11-30,"South America",13,6987,114,181,7282
2012-12-31,"Africa",35,31563,4893,733,37189
2012-12-31,"Asia",26,35648,6691,600,42939
2012-12-31,"Europe",33,5335,382,396,6113
2012-12-31,"North America",2,30,220,28,278
2012-12-31,"Oceania",6,212,75,37,324
2012-12-31,"South America",13,6953,108,177,7238
2013-01-31,"Africa",35,31698,4787,751,37236
2013-01-31,"Asia",25,34938,6673,614,42225
2013-01-31,"Europe",33,5334,386,405,6125
2013-01-31,"North America",2,30,189,28,247
2013-01-31,"Oceania",6,210,75,37,322
2013-01-31,"South America",13,6821,105,163,7089
2013-02-28,"Africa",34,31652,4832,712,37196
2013-02-28,"Asia",25,34923,6886,532,42341
2013-02-28,"Europe",34,5389,394,377,6160
2013-02-28,"North America",2,43,188,17,248
2013-02-28,"Oceania",6,210,78,37,325
2013-02-28,"South America",13,6830,111,157,7098
2013-03-31,"Africa",35,30903,4904,689,36496
2013-03-31,"Asia",26,34883,6860,544,42287
2013-03-31,"Europe",34,5293,398,380,6071
2013-03-31,"North America",2,43,190,17,250
2013-03-31,"Oceania",6,211,77,37,325
2013-03-31,"South America",13,6829,122,161,7112
2013-04-30,"Africa",35,30617,4932,721,36270
2013-04-30,"Asia",26,35046,6837,546,42429
2013-04-30,"Europe",34,5468,415,377,6260
2013-04-30,"North America",2,42,180,17,239
2013-04-30,"Oceania",6,212,77,38,327
2013-04-30,"South America",13,6589,121,172,6882
2013-05-31,"Africa",35,29472,4895,713,35080
2013-05-31,"Asia",26,34893,6776,526,42195
2013-05-31,"Europe",34,5304,407,374,6085
2013-05-31,"North America",2,42,181,18,241
2013-05-31,"Oceania",6,212,77,38,327
2013-05-31,"South America",13,6322,124,177,6623
2013-06-30,"Africa",34,30936,5065,707,36708
2013-06-30,"Asia",25,34100,6796,527,41423
2013-06-30,"Europe",34,4924,412,371,5707
2013-06-30,"North America",2,79,164,18,261
2013-06-30,"Oceania",6,395,81,38,514
2013-06-30,"South America",13,6318,108,177,6603
2013-07-31,"Africa",36,36430,5639,694,42763
2013-07-31,"Asia",25,34158,6826,539,41523
2013-07-31,"Europe",34,4845,407,368,5620
2013-07-31,"North America",2,77,162,18,257
2013-07-31,"Oceania",6,709,81,39,829
2013-07-31,"South America",12,6332,101,177,6610
2013-08-31,"Africa",36,36108,5620,702,42430
2013-08-31,"Asia",25,34206,6565,537,41308
2013-08-31,"Europe",34,4934,407,373,5714
2013-08-31,"North America",2,80,169,18,267
2013-08-31,"Oceania",6,709,76,38,823
2013-08-31,"South America",13,6358,99,176,6633
2013-09-30,"Africa",37,36232,5390,720,42342
2013-09-30,"Asia",25,34023,6550,553,41126
2013-09-30,"Europe",34,5186,410,380,5976
2013-09-30,"North America",2,74,175,19,268
2013-09-30,"Oceania",6,685,79,39,803
2013-09-30,"South America",13,6358,105,179,6642
2013-10-31,"Africa",38,36849,5350,705,42904
2013-10-31,"Asia",24,34075,6724,554,41353
2013-10-31,"Europe",35,5544,394,379,6317
2013-10-31,"North America",2,82,161,26,269
2013-10-31,"Oceania",7,709,85,42,836
2013-10-31,"South America",13,6352,97,183,6632
2013-11-30,"Africa",38,37131,5397,682,43210
2013-11-30,"Asia",24,33907,6733,554,41194
2013-11-30,"Europe",35,5560,412,378,6350
2013-11-30,"North America",2,43,158,19,220
2013-11-30,"Oceania",7,719,108,36,863
2013-11-30,"South America",14,6140,109,181,6430
2013-12-31,"Africa",38,37130,5612,690,43432
2013-12-31,"Asia",25,33936,6634,562,41132
2013-12-31,"Europe",36,5127,420,374,5921
2013-12-31,"North America",2,42,172,19,233
2013-12-31,"Oceania",6,718,100,34,852
2013-12-31,"South America",15,6326,119,185,6630
2014-01-31,"Africa",38,36835,5671,690,43196
2014-01-31,"Asia",25,34309,6706,551,41566
2014-01-31,"Europe",36,5215,426,374,6015
2014-01-31,"North America",2,43,167,19,229
2014-01-31,"Oceania",7,720,96,36,852
2014-01-31,"South America",15,6580,114,187,6881
2014-02-28,"Africa",38,36731,5661,690,43082
2014-02-28,"Asia",25,34384,6630,560,41574
2014-02-28,"Europe",35,5245,418,379,6042
2014-02-28,"North America",2,52,172,19,243
2014-02-28,"Oceania",7,723,72,38,833
2014-02-28,"South America",15,6289,108,179,6576
